1111111111111111111111111111111111
1x0C00000x00000C00000C0000000E0001
1010010100100x00101001000z00010101
10100100101010100C1001000000010101
1Px000000C0000000000y000C0000000C1
1111111111111111111111111111111111