1111111111111
111P000000111
111110000C111
1111E10000001
1111111111111