1111111111111
1P01000000001
100E010000001
100C010000001
1111111111111
